###############
#S   #       E#
# # ### ##### #
# #     #     #
# ##### # ### #
#     #   #   #
###############
