########
#      #
# ###E##
#      #
########
