########
#S     #
# ###E##
#      #
########
